  ____                    _         ____                       
 / ___| _   _ _ __  _ __ | |_   _  |  _ \ ___   ___  _ __ ___  
 \___ \| | | | '_ \| '_ \| | | | | | |_) / _ \ / _ \| '_ ` _ \ 
  ___) | |_| | |_) | |_) | | |_| | |  _ < (_) | (_) | | | | | |
 |____/ \__,_| .__/| .__/|_|\__, | |_| \_\___/ \___/|_| |_| |_|
             |_|   |_|      |___/                              
